1111111111111111111111111111111111111111
10C000000000C0000000000C0000000000000001
1011110111110101011111101011111010111111
1000000100000101010000101000000010100001
1011100101110101010111101010111110101111
1010000101000100010100001010000010000011
1011110101111101110101111011111011111011
1000000100000101000101000000000010000E11
1011110111110101010101011111101011111111
10000000000000000000000000000000000000P1
1111111111111111111111111111111111111111
