111111111111111111111111111111
100000000000000000000000000001
101111011111011110111101111101
100001010001C00010000100010001
101111011101111010111101111101
100000000000000000000000000001
101111111111111111111111111101
100000000000000C00000000000001
111111101111011111111011111111
100000100000010000000100000001
101110101110101110111010111101
1010101000101E0010001010100101
101011101011101010111010101101
100000001000000P00000001000001
101111111111111111111111111101
100000000000000000000000000001
111111111111111111111111111111
