11111111111
10000P00011
1000000E011
100000C0011
10000000011
11111111111